Altruism: Give up powers or riches for the greater good.
Anarchy: Upset the rightful order.
Art: Create or perform a work of quality to overcome an obstacle.
Brutality: Kill a defenseless or surrendered enemy.
Charity: Give your rewards to those in need.
Deceit: Shift danger or blame from yourself to someone else.
Deviousness: Twist someoneâ€™s words to your benefit.
Discovery: Uncover a secret or learn about something about a mystery.
Emancipation: Free someone from literal or figurative bonds.
Equality: Balance the scales.
Faith: Aid the faithful or hinder those who would oppose your god.
Fraud: Take advantage of someone's trust.
Glory: Lead others into righteous battle.
Honor: Forego personal gain to fulfill a promise of import.
Influence: Make an ally of someone powerful.
Justice: Bring a criminal to justice.
Legalism: Uphold the letter of the law over the spirit.
Mercy: Forgive someone who should be punished.
Nature: Protect the wilderness.
Order: Fight against those who would overturn civilization.
Peace: Avoid conflict or defuse a tense situation.
Primitivism: Eschew a convention of the civilized world.
Punishment: Deny mercy to a criminal or unbeliever.
Recklessness: Leap into danger without a plan.
Reform: Reveal corruption or hypocrisy.
Restoration: Return treasure to its rightful owner.
Revolution: Break an unjust law or defeat an oppressor..
Sadism: Harm an innocent.
Sanctity: Endanger yourself to combat an unholy threat.
Savagery: Destroy beauty or tranquility..
Spontaneity: Spur others to significant and unplanned action.
Stealth: Avoid detection or infiltrate a location.
Terror: Cause fear in the hearts of your opposition.
Torture: Cause suffering for its own sake.
Trustworthiness: Follow through on your word.
Truth: Reveal a dangerous lie.
Tyranny: Harm another to prove the superiority of your convictions.
Valor: Defeat a worthy opponent through combat.
